111111111111111111111111111
1CCCCCCCCCCCCCCCCCCCCCCCCC1
1111111111111C1111111111111
1111111111111C1111111111111
111111111111101111111111111
1000000111111C1111111000001
1000000111111C1111111000001
1C00000000000C00000000000C1
1C10000000000000000000001C1
101000000000000000000000101
101000000000000000000000101
1P10000000000000000000001E1
111111111111111111111111111