map/0.xpm
111111111111111111111111111111111111111111111111111111111111111111111111111111112
100000000000000000000000000000000000000000000000000000000000000000000000000000002
100000000000000000000000000000000000000000000000000000000000000000000000000000002
100000000000000000000000000000000000000000000000000000000000000000000000000000002
100000000000000000000000000000000000000000000000000000000000000000000000000000002
1000000A0000000000000000000000000000000000000000000000000000000000000000000000002
100000000000000000000000000000000000000000000000000000000000000000000000000000002
100000000000000000000000000000000000000000000000000000000000000000000000000000002
100000000I00000000000000000000000000000000000000000111111111111111011101111110002
100P00I0A00S000000000000000000000000000000000011111111111111111111000001111111112
111111111111111111111100111111111111111111111111111111111111111111000001111111112
111111111111111111111100111111111111111111111111111111111111111111000001111111112
100000000000000000000000000000000000000000000000000000000000000000000000000000002
100000000000000000000000000000000000000000000000000000000000000000000000000000002
111111111111111111111111111111111111111111111111111111111111111111111111111111112