map/1.xpm
1111111111111111111111111111111111111111111111111111111111111111111112
1000000000000000000000000000000000000000000000000000000000000000000002
1000000000000000000000000000000000000000000000000000000000000000000002
1000000000000000000000000000000000000000000000000000000000000000000002
1000000000000000000000000000000000000000000000000000000000000000000002
1000000000000000000000000000000000000000000000000000000000000000000002
1000000000000000000000000000000000000000000000000000000000000000000002
1000000000000000000000000000000000000000000000000000000000000000000002
1000000000000000000000000000000000000000000000000000000000000000000002
1000000000000000000000000000000000000000000000000000011111100111110002
10P0000000000111111110011111111111111100111111111111111111100111111112
1111111100110000000000011111111111111100111111111111111111100111111112
1000000000000000000000000000000000000000000000000000000000000000000002
1000000000000000000000000000000000000000000000000000000000000000000002
1111111111111111111111111111111111111111111111111111111111111111111112